View Set	Product Count
A - HZ - 999 - life moments	<html>0  (<font color=red>0</font>)</html>
A - HZ - 999 - wedding	<html>5  (<font color=red>0</font>)</html>
A - HZ - 999 business	<html>4  (<font color=red>0</font>)</html>
A - HZ - business	<html>117  (<font color=red>36</font>)</html>
A - HZ - business - carrier card	<html>18  (<font color=red>0</font>)</html>
A - HZ - life moments - BABY	<html>162  (<font color=red>162</font>)</html>
A - HZ - life moments - GRAD	<html>17  (<font color=red>12</font>)</html>
A - HZ - life moments - MOVE	<html>14  (<font color=red>0</font>)</html>
A - HZ - life moments - PARTY	<html>48  (<font color=red>0</font>)</html>
A - HZ - life moments - QUINCE	<html>5  (<font color=red>0</font>)</html>
A - HZ - life moments - QUINCE - carrier	<html>1  (<font color=red>0</font>)</html>
A - HZ - school	<html>76  (<font color=red>2</font>)</html>
A - HZ - wedding - WW	<html>236  (<font color=red>42</font>)</html>
A - HZ - wedding - WW Carrier	<html>69  (<font color=red>0</font>)</html>
A - VT - 999 - life moments	<html>2  (<font color=red>0</font>)</html>
A - VT - 999 - wedding	<html>2  (<font color=red>0</font>)</html>
A - VT - 999 business	<html>4  (<font color=red>0</font>)</html>
A - VT - business	<html>65  (<font color=red>138</font>)</html>
A - VT - businesss - carrier card	<html>25  (<font color=red>0</font>)</html>
A - VT - life moments - BABY	<html>103  (<font color=red>20</font>)</html>
A - VT - life moments - GRAD	<html>16  (<font color=red>9</font>)</html>
A - VT - life moments - MOVE	<html>23  (<font color=red>0</font>)</html>
A - VT - life moments - PARTY	<html>62  (<font color=red>0</font>)</html>
A - VT - life moments - QUINCE	<html>3  (<font color=red>0</font>)</html>
A - VT - life moments - QUINCE - carrier	<html>10  (<font color=red>0</font>)</html>
A - VT - school	<html>70  (<font color=red>26</font>)</html>
A - VT - wedding - WW	<html>284  (<font color=red>2</font>)</html>
A - VT - wedding - WW Carrier	<html>118  (<font color=red>0</font>)</html>
AB - HZ - 999 business	<html>2  (<font color=red>0</font>)</html>
AB - VT - 999 business	<html>2  (<font color=red>0</font>)</html>
AC - HZ - 999 business	<html>2  (<font color=red>0</font>)</html>
AC - VT - 999 business	<html>2  (<font color=red>0</font>)</html>
AL - HZ - life moments - BABY	<html>126  (<font color=red>20</font>)</html>
AL - HZ - life moments - GRAD	<html>17  (<font color=red>12</font>)</html>
AL - HZ - life moments - MOVE	<html>14  (<font color=red>0</font>)</html>
AL - HZ - life moments - PARTY	<html>74  (<font color=red>0</font>)</html>
AL - HZ - life moments - QUINCE	<html>1  (<font color=red>0</font>)</html>
AL - VT - life moments - BABY	<html>89  (<font color=red>20</font>)</html>
AL - VT - life moments - GRAD	<html>16  (<font color=red>9</font>)</html>
AL - VT - life moments - MOVE	<html>24  (<font color=red>0</font>)</html>
AL - VT - life moments - PARTY	<html>68  (<font color=red>0</font>)</html>
AL - VT - life moments - QUINCE	<html>10  (<font color=red>0</font>)</html>
B - HZ - 999 - life moments	<html>0  (<font color=red>0</font>)</html>
B - HZ - 999 - wedding	<html>3  (<font color=red>0</font>)</html>
B - HZ - 999 business	<html>6  (<font color=red>0</font>)</html>
B - HZ - business	<html>292  (<font color=red>22</font>)</html>
B - HZ - life moments - QUINCE	<html>0  (<font color=red>0</font>)</html>
B - HZ - school	<html>58  (<font color=red>27</font>)</html>
B - HZ - wedding - WW	<html>190  (<font color=red>116</font>)</html>
B - HZ - wedding - WW Carrier	<html>60  (<font color=red>0</font>)</html>
B - VT - 999 - wedding	<html>1  (<font color=red>0</font>)</html>
B - VT - 999 business	<html>4  (<font color=red>0</font>)</html>
B - VT - business	<html>48  (<font color=red>7</font>)</html>
B - VT - life moments - QUINCE	<html>0  (<font color=red>0</font>)</html>
B - VT - school	<html>30  (<font color=red>2</font>)</html>
B - VT - wedding - WW	<html>201  (<font color=red>106</font>)</html>
B - VT - wedding - WW Carrier	<html>83  (<font color=red>0</font>)</html>
BBA - wedding	<html>429  (<font color=red>11</font>)</html>
BBA - wedding 999	<html>1  (<font color=red>0</font>)</html>
BBB - wedding	<html>252  (<font color=red>9</font>)</html>
BBB - wedding 999	<html>2  (<font color=red>0</font>)</html>
BBC - wedding	<html>190  (<font color=red>3</font>)</html>
BBC - wedding 999	<html>1  (<font color=red>0</font>)</html>
BBD - wedding	<html>190  (<font color=red>3</font>)</html>
BBD - wedding 999	<html>1  (<font color=red>0</font>)</html>
BBE - wedding	<html>211  (<font color=red>3</font>)</html>
BBE - wedding 999	<html>1  (<font color=red>0</font>)</html>
BBF - wedding	<html>210  (<font color=red>3</font>)</html>
BBF - wedding 999	<html>1  (<font color=red>0</font>)</html>
BH - HZ - 999 business	<html>3  (<font color=red>0</font>)</html>
BH - VT - 999 business	<html>3  (<font color=red>0</font>)</html>
C - HZ - 999 business	<html>4  (<font color=red>0</font>)</html>
C - HZ - business	<html>51  (<font color=red>210</font>)</html>
C - HZ - business - Inserts	<html>202  (<font color=red>2</font>)</html>
C - HZ - schools	<html>118  (<font color=red>5</font>)</html>
C - VT - 999 business	<html>4  (<font color=red>0</font>)</html>
C - VT - business	<html>41  (<font color=red>58</font>)</html>
C - VT - business - Inserts	<html>222  (<font color=red>10</font>)</html>
C - VT - schools	<html>119  (<font color=red>58</font>)</html>
CA - business	<html>0  (<font color=red>0</font>)</html>
CF - 999 business	<html>3  (<font color=red>0</font>)</html>
CPA Canvas	<html>23  (<font color=red>3</font>)</html>
CPA Canvas - weddings	<html>71  (<font color=red>4</font>)</html>
CPB Canvas	<html>25  (<font color=red>6</font>)</html>
CPB Canvas - weddings	<html>70  (<font color=red>3</font>)</html>
CPC Canvas	<html>26  (<font color=red>5</font>)</html>
CPC Canvas - weddings	<html>74  (<font color=red>2</font>)</html>
CPD Canvas	<html>14  (<font color=red>1</font>)</html>
CPD Canvas - weddings	<html>67  (<font color=red>3</font>)</html>
CPE Canvas	<html>27  (<font color=red>3</font>)</html>
CPE Canvas - weddings	<html>68  (<font color=red>3</font>)</html>
CPF Canvas	<html>25  (<font color=red>4</font>)</html>
CPF Canvas - weddings	<html>67  (<font color=red>3</font>)</html>
CPG Canvas	<html>24  (<font color=red>5</font>)</html>
CPG Canvas - weddings	<html>64  (<font color=red>3</font>)</html>
CPH Canvas	<html>22  (<font color=red>2</font>)</html>
CPH Canvas - weddings	<html>64  (<font color=red>2</font>)</html>
CPI Canvas	<html>23  (<font color=red>5</font>)</html>
CPI Canvas - weddings	<html>70  (<font color=red>1</font>)</html>
CPJ Canvas	<html>24  (<font color=red>5</font>)</html>
CPJ Canvas - weddings	<html>70  (<font color=red>1</font>)</html>
CPK Canvas	<html>6  (<font color=red>2</font>)</html>
CPK Canvas - weddings	<html>66  (<font color=red>3</font>)</html>
CPL Canvas	<html>27  (<font color=red>4</font>)</html>
CPL Canvas - weddings	<html>69  (<font color=red>1</font>)</html>
CPM Canvas	<html>25  (<font color=red>4</font>)</html>
CPM Canvas - weddings	<html>68  (<font color=red>1</font>)</html>
CPN Canvas	<html>21  (<font color=red>7</font>)</html>
CPN Canvas - weddings	<html>67  (<font color=red>1</font>)</html>
CPO Canvas	<html>20  (<font color=red>5</font>)</html>
CPO Canvas - weddings	<html>67  (<font color=red>1</font>)</html>
CT - HZ - 999 - life moments	<html>0  (<font color=red>0</font>)</html>
CT - HZ - 999 - wedding	<html>12  (<font color=red>0</font>)</html>
CT - HZ - 999 business	<html>2  (<font color=red>0</font>)</html>
CT - HZ - christmas	<html>108  (<font color=red>6</font>)</html>
CT - HZ - school	<html>8  (<font color=red>10</font>)</html>
CT - HZ - Schools	<html>0  (<font color=red>0</font>)</html>
CT - HZ - wedding - WW	<html>146  (<font color=red>0</font>)</html>
CT - VT - 999 - life moments	<html>0  (<font color=red>0</font>)</html>
CT - VT - 999 - wedding	<html>11  (<font color=red>0</font>)</html>
CT - VT - 999 business	<html>2  (<font color=red>0</font>)</html>
CT - VT - christmas	<html>122  (<font color=red>14</font>)</html>
CT - VT - Schools	<html>15  (<font color=red>0</font>)</html>
CT - VT - wedding - WW	<html>233  (<font color=red>2</font>)</html>
CTL - HZ - 999 - wedding	<html>4  (<font color=red>0</font>)</html>
CTL - HZ - business	<html>0  (<font color=red>0</font>)</html>
CTL - HZ - business cfa	<html>5  (<font color=red>0</font>)</html>
CTL - HZ - schools	<html>2  (<font color=red>10</font>)</html>
CTL - HZ - wedding - WW	<html>100  (<font color=red>0</font>)</html>
CTL - VT - 999 - wedding	<html>4  (<font color=red>0</font>)</html>
CTL - VT - wedding - WW	<html>164  (<font color=red>0</font>)</html>
D - HZ - 999 - life moments	<html>0  (<font color=red>0</font>)</html>
D - HZ - 999 - wedding	<html>2  (<font color=red>0</font>)</html>
D - HZ - 999 business	<html>4  (<font color=red>0</font>)</html>
D - HZ - business	<html>10  (<font color=red>4</font>)</html>
D - HZ - business - Inserts	<html>163  (<font color=red>3</font>)</html>
D - HZ - school	<html>95  (<font color=red>6</font>)</html>
D - HZ - wedding - WW	<html>71  (<font color=red>0</font>)</html>
D - VT - 999 - life moments	<html>0  (<font color=red>0</font>)</html>
D - VT - 999 - wedding 	<html>2  (<font color=red>0</font>)</html>
D - VT - 999 business	<html>4  (<font color=red>0</font>)</html>
D - VT - business	<html>13  (<font color=red>382</font>)</html>
D - VT - business - Inserts	<html>196  (<font color=red>6</font>)</html>
D - VT - school	<html>93  (<font color=red>64</font>)</html>
D - VT - wedding - WW	<html>157  (<font color=red>0</font>)</html>
DA - HZ - 999 business	<html>2  (<font color=red>0</font>)</html>
DA - VT - 999 business	<html>2  (<font color=red>0</font>)</html>
DC - HZ - 999 - life moments	<html>0  (<font color=red>0</font>)</html>
DC - HZ - 999 - wedding	<html>4  (<font color=red>0</font>)</html>
DC - HZ - 999 business	<html>2  (<font color=red>0</font>)</html>
DC - HZ - life moments - BABY	<html>101  (<font color=red>7</font>)</html>
DC - HZ - life moments - GRAD	<html>9  (<font color=red>3</font>)</html>
DC - HZ - life moments - PARTY	<html>39  (<font color=red>0</font>)</html>
DC - HZ - wedding - WW	<html>143  (<font color=red>0</font>)</html>
DC - VT - 999 - life moments	<html>0  (<font color=red>0</font>)</html>
DC - VT - 999 - wedding	<html>4  (<font color=red>0</font>)</html>
DC - VT - 999 business	<html>2  (<font color=red>0</font>)</html>
DC - VT - life moments - BABY	<html>66  (<font color=red>9</font>)</html>
DC - VT - life moments - GRAD	<html>19  (<font color=red>2</font>)</html>
DC - VT - life moments - PARTY	<html>54  (<font color=red>0</font>)</html>
DC - VT - wedding - WW	<html>192  (<font color=red>7</font>)</html>
DCL - HZ - 999 - life moments	<html>1  (<font color=red>0</font>)</html>
DCL - HZ - 999 - wedding	<html>3  (<font color=red>0</font>)</html>
DCL - HZ - life moments - BABY	<html>124  (<font color=red>7</font>)</html>
DCL - HZ - life moments - GRAD	<html>9  (<font color=red>3</font>)</html>
DCL - HZ - life moments - PARTY	<html>38  (<font color=red>0</font>)</html>
DCL - HZ - wedding - WW	<html>158  (<font color=red>0</font>)</html>
DCL - VT - 999 - life moments	<html>2  (<font color=red>0</font>)</html>
DCL - VT - 999 - wedding	<html>2  (<font color=red>0</font>)</html>
DCL - VT - life moments - BABY	<html>88  (<font color=red>9</font>)</html>
DCL - VT - life moments - GRAD	<html>19  (<font color=red>2</font>)</html>
DCL - VT - life moments - PARTY	<html>52  (<font color=red>0</font>)</html>
DCL - VT - wedding - WW	<html>206  (<font color=red>8</font>)</html>
DCLD - HZ - wedding - WW	<html>327  (<font color=red>0</font>)</html>
DCLD - VT - wedding - WW	<html>367  (<font color=red>0</font>)</html>
DE - 999 business	<html>1  (<font color=red>1</font>)</html>
DE - business	<html>0  (<font color=red>62</font>)</html>
DGT - wedding - backgrounds	<html>19  (<font color=red>11</font>)</html>
DGT - wedding - backgrounds - saving old	<html>0  (<font color=red>0</font>)</html>
DGT - wedding - canvas	<html>0  (<font color=red>0</font>)</html>
DGT - wedding - four colors	<html>1  (<font color=red>0</font>)</html>
DGT - wedding - marketing	<html>4  (<font color=red>0</font>)</html>
DGT - wedding - one colors	<html>1  (<font color=red>0</font>)</html>
DGT - wedding - three colors	<html>1  (<font color=red>0</font>)</html>
DGT - wedding - two colors	<html>1  (<font color=red>0</font>)</html>
DHB - 999 business	<html>4  (<font color=red>0</font>)</html>
DHB - business	<html>2  (<font color=red>0</font>)</html>
DHB - business - WW	<html>0  (<font color=red>0</font>)</html>
DT - HZ - 999 business	<html>2  (<font color=red>0</font>)</html>
DT - VT - 999 business	<html>2  (<font color=red>0</font>)</html>
DT - VT - business	<html>2  (<font color=red>0</font>)</html>
DT - VT - business Baseball 100 (composite) WW	<html>31  (<font color=red>0</font>)</html>
DT - VT - business Baseball 150 (Composite) WW	<html>31  (<font color=red>0</font>)</html>
DT - VT - business Football 200 (Composite) WW	<html>270  (<font color=red>6</font>)</html>
DT - VT - business Football 250 (Composite) WW	<html>0  (<font color=red>0</font>)</html>
E - 999 business	<html>4  (<font color=red>0</font>)</html>
E - business	<html>117  (<font color=red>5</font>)</html>
E - school	<html>41  (<font color=red>1</font>)</html>
ELA - wedding	<html>335  (<font color=red>8</font>)</html>
ELA - wedding 999	<html>2  (<font color=red>0</font>)</html>
ELC - wedding	<html>191  (<font color=red>3</font>)</html>
ELC - wedding 999	<html>2  (<font color=red>0</font>)</html>
ELD - wedding	<html>187  (<font color=red>3</font>)</html>
ELD - wedding 999	<html>2  (<font color=red>0</font>)</html>
ELE - wedding	<html>269  (<font color=red>7</font>)</html>
ELE - wedding 999	<html>2  (<font color=red>0</font>)</html>
ELF - wedding	<html>288  (<font color=red>6</font>)</html>
ELF - wedding 999	<html>2  (<font color=red>0</font>)</html>
ELH - wedding	<html>0  (<font color=red>32</font>)</html>
ELI - wedding	<html>0  (<font color=red>32</font>)</html>
ELJ - wedding	<html>0  (<font color=red>32</font>)</html>
ENV - business -10	<html>2  (<font color=red>4</font>)</html>
ENV-000 - wedding	<html>3  (<font color=red>0</font>)</html>
ENV-010 - wedding	<html>3  (<font color=red>0</font>)</html>
ENV-020 - wedding	<html>6  (<font color=red>0</font>)</html>
ENV-030 - wedding	<html>6  (<font color=red>0</font>)</html>
ENV-040 - wedding RSVP	<html>3  (<font color=red>0</font>)</html>
ENV-040W - wedding	<html>6  (<font color=red>0</font>)</html>
ENV-045 - wedding 	<html>6  (<font color=red>0</font>)</html>
ENV-055 - wedding	<html>6  (<font color=red>0</font>)</html>
ENV-075 - wedding RSVP	<html>3  (<font color=red>0</font>)</html>
ENV-075W - wedding 	<html>6  (<font color=red>0</font>)</html>
ENV-090 - wedding	<html>5  (<font color=red>1</font>)</html>
ENVG-000 - wedding	<html>1  (<font color=red>0</font>)</html>
ENVG-010 - wedding	<html>2  (<font color=red>0</font>)</html>
ENVG-020 - wedding	<html>1  (<font color=red>0</font>)</html>
ENVG-030 - wedding	<html>1  (<font color=red>0</font>)</html>
ENVG-040W - wedding	<html>2  (<font color=red>0</font>)</html>
ENVG-045 - wedding	<html>2  (<font color=red>10</font>)</html>
ENVG-055 - wedding	<html>2  (<font color=red>0</font>)</html>
ENVG-075W - wedding	<html>1  (<font color=red>1</font>)</html>
ENVG-090 - wedding	<html>1  (<font color=red>0</font>)</html>
ENVINC-000 Weddings -WW	<html>5  (<font color=red>0</font>)</html>
ENVINC-010 Weddings -WW	<html>5  (<font color=red>1</font>)</html>
ENVINC-020 Weddings -WW	<html>2  (<font color=red>0</font>)</html>
ENVINC-030 Weddings -WW	<html>2  (<font color=red>0</font>)</html>
ENVINC-040W Weddings -WW	<html>3  (<font color=red>1</font>)</html>
ENVINC-045 Weddings -WW	<html>2  (<font color=red>1</font>)</html>
ENVINC-055 Weddings -WW	<html>2  (<font color=red>1</font>)</html>
ENVINC-075W Weddings -WW	<html>3  (<font color=red>1</font>)</html>
ENVINC-090 Weddings -WW	<html>2  (<font color=red>0</font>)</html>
ENVINC-0F1 Weddings -WW	<html>0  (<font color=red>1</font>)</html>
ENVINC-0F2 Weddings -WW	<html>0  (<font color=red>1</font>)</html>
ENVMS - business - 10200	<html>0  (<font color=red>3</font>)</html>
ENVMS - business - 10250	<html>0  (<font color=red>1</font>)</html>
ENVMS - business - sports	<html>2  (<font color=red>2</font>)</html>
ENVMS - business -10	<html>2  (<font color=red>0</font>)</html>
ENVMS-010 - business	<html>1  (<font color=red>0</font>)</html>
ENVMS-a - business	<html>1  (<font color=red>0</font>)</html>
ENVMS-c - business	<html>1  (<font color=red>1</font>)</html>
ENVMS-d - business	<html>1  (<font color=red>0</font>)</html>
ENVMS-e - business	<html>1  (<font color=red>0</font>)</html>
ENVMS-gfp - business	<html>1  (<font color=red>0</font>)</html>
ENVMS-m - business	<html>1  (<font color=red>0</font>)</html>
ENVMS-t - business	<html>1  (<font color=red>0</font>)</html>
ENVR - business - 10100	<html>0  (<font color=red>0</font>)</html>
ENVR - business - 10110	<html>0  (<font color=red>1</font>)</html>
ENVR - business - 10120	<html>0  (<font color=red>1</font>)</html>
ENVR - business - 10150	<html>0  (<font color=red>0</font>)</html>
ENVR - business - 10200	<html>0  (<font color=red>2</font>)</html>
ENVR - business - 10250	<html>0  (<font color=red>2</font>)</html>
ENVR - business - sports	<html>2  (<font color=red>0</font>)</html>
ENVR - business -10	<html>0  (<font color=red>0</font>)</html>
ENVR-000 - wedding	<html>1  (<font color=red>0</font>)</html>
ENVR-010 - wedding	<html>5  (<font color=red>0</font>)</html>
ENVR-020 - wedding	<html>2  (<font color=red>0</font>)</html>
ENVR-030 - wedding	<html>1  (<font color=red>0</font>)</html>
ENVR-040 - wedding RSVP	<html>1  (<font color=red>0</font>)</html>
ENVR-040W - wedding	<html>3  (<font color=red>0</font>)</html>
ENVR-045 - wedding	<html>2  (<font color=red>0</font>)</html>
ENVR-055 - wedding	<html>2  (<font color=red>0</font>)</html>
ENVR-075 - wedding RSVP	<html>2  (<font color=red>0</font>)</html>
ENVR-075W - wedding	<html>1  (<font color=red>1</font>)</html>
ENVR-090 - wedding	<html>1  (<font color=red>0</font>)</html>
ENVR-10 - business	<html>1  (<font color=red>0</font>)</html>
ENVR-a - business	<html>1  (<font color=red>0</font>)</html>
ENVR-c - business	<html>1  (<font color=red>0</font>)</html>
ENVR-d - business	<html>1  (<font color=red>0</font>)</html>
ENVR-e - business	<html>1  (<font color=red>0</font>)</html>
ENVR-gfp - business	<html>1  (<font color=red>0</font>)</html>
ENVR-m - business	<html>1  (<font color=red>0</font>)</html>
ENVR-t - business	<html>1  (<font color=red>0</font>)</html>
FB - 999 business	<html>2  (<font color=red>0</font>)</html>
FB - business	<html>0  (<font color=red>13</font>)</html>
FB - business football	<html>176  (<font color=red>4</font>)</html>
FB - business football - WW	<html>0  (<font color=red>0</font>)</html>
FCMS	<html>14  (<font color=red>0</font>)</html>
FLYA - HZ - school	<html>6  (<font color=red>4</font>)</html>
FLYAS - HZ - school 	<html>0  (<font color=red>0</font>)</html>
FLYB - VT - business	<html>0  (<font color=red>0</font>)</html>
FLYB - VT - business cfa	<html>5  (<font color=red>0</font>)</html>
FLYC - VT - business	<html>0  (<font color=red>0</font>)</html>
FLYC - VT - business cfa	<html>0  (<font color=red>1</font>)</html>
FLYD - HZ - school	<html>4  (<font color=red>0</font>)</html>
FLYDS - HZ - school	<html>4  (<font color=red>0</font>)</html>
FLYE - HZ - school	<html>2  (<font color=red>0</font>)</html>
FLYES - HZ - school	<html>6  (<font color=red>0</font>)</html>
FLYF - VT - school	<html>4  (<font color=red>0</font>)</html>
FLYFS - VT - school	<html>4  (<font color=red>0</font>)</html>
FP - business	<html>0  (<font color=red>6</font>)</html>
FP 200 - business	<html>2  (<font color=red>0</font>)</html>
FP 204 - business	<html>2  (<font color=red>0</font>)</html>
FP 205 - business	<html>2  (<font color=red>0</font>)</html>
FP 211 - business	<html>2  (<font color=red>0</font>)</html>
FP 212 - business	<html>2  (<font color=red>0</font>)</html>
FP 224 - business	<html>2  (<font color=red>0</font>)</html>
FP 225 - business	<html>2  (<font color=red>0</font>)</html>
FP 227 - business	<html>2  (<font color=red>0</font>)</html>
FP 235 - business	<html>2  (<font color=red>0</font>)</html>
FP 236 - business	<html>2  (<font color=red>0</font>)</html>
FP 237 - business	<html>2  (<font color=red>0</font>)</html>
FP 238 - business	<html>2  (<font color=red>0</font>)</html>
FP 239 - business	<html>2  (<font color=red>0</font>)</html>
FP 240 - business	<html>3  (<font color=red>0</font>)</html>
FWA - wedding	<html>0  (<font color=red>119</font>)</html>
FWB - wedding	<html>0  (<font color=red>119</font>)</html>
FWC - wedding	<html>1  (<font color=red>119</font>)</html>
G - HZ - business	<html>11  (<font color=red>8</font>)</html>
G - HZ - business 999	<html>4  (<font color=red>0</font>)</html>
G - HZ - school	<html>2  (<font color=red>0</font>)</html>
G - VT - business	<html>30  (<font color=red>18</font>)</html>
G - VT - business 999	<html>4  (<font color=red>0</font>)</html>
G - VT - school	<html>11  (<font color=red>11</font>)</html>
GC - HZ - business	<html>10  (<font color=red>6</font>)</html>
GC - HZ - business 999	<html>4  (<font color=red>0</font>)</html>
GC - HZ - school	<html>2  (<font color=red>0</font>)</html>
GC - VT - business	<html>37  (<font color=red>17</font>)</html>
GC - VT - business 999	<html>4  (<font color=red>0</font>)</html>
GC - VT - school	<html>6  (<font color=red>1</font>)</html>
HA - HZ - business	<html>25  (<font color=red>0</font>)</html>
HA - HZ - school	<html>4  (<font color=red>0</font>)</html>
HA - HZ - wedding	<html>464  (<font color=red>410</font>)</html>
HA - VT - business	<html>5  (<font color=red>0</font>)</html>
HA - VT - school	<html>4  (<font color=red>0</font>)</html>
HA - VT - wedding	<html>105  (<font color=red>31</font>)</html>
HB - HZ (w)	<html>0  (<font color=red>0</font>)</html>
HB - HZ - 999 - business	<html>1  (<font color=red>0</font>)</html>
HB - HZ - business	<html>25  (<font color=red>0</font>)</html>
HB - HZ - business (W)	<html>0  (<font color=red>0</font>)</html>
HB - HZ - christmas	<html>129  (<font color=red>18</font>)</html>
HB - HZ - wedding - CLASSIC	<html>0  (<font color=red>28</font>)</html>
HB - HZ - wedding - RUSTIC	<html>0  (<font color=red>7</font>)</html>
HB - VT (w) 	<html>0  (<font color=red>0</font>)</html>
HB - VT - 999 - business	<html>1  (<font color=red>0</font>)</html>
HB - VT - business	<html>4  (<font color=red>0</font>)</html>
HB - VT - business (w)	<html>0  (<font color=red>0</font>)</html>
HB - VT - Christmas	<html>66  (<font color=red>12</font>)</html>
HB - VT - wedding - CLASSIC	<html>0  (<font color=red>0</font>)</html>
HB - VT - wedding - RUSTIC	<html>0  (<font color=red>0</font>)</html>
HBT - HZ - christmas - a magnet	<html>21  (<font color=red>0</font>)</html>
HBT - HZ - christmas - c magnet	<html>5  (<font color=red>0</font>)</html>
HBT - VT - christmas - a magnet	<html>11  (<font color=red>1</font>)</html>
HBT - VT - christmas - a magnet business	<html>0  (<font color=red>0</font>)</html>
HBT - VT - christmas - c magnet	<html>9  (<font color=red>0</font>)</html>
HBT - VT - christmas - c magnet business	<html>0  (<font color=red>0</font>)</html>
HBT - VT - christmas - t calendar	<html>0  (<font color=red>3</font>)</html>
HBT - VT - christmas - t calendar business	<html>6  (<font color=red>0</font>)</html>
HC - HZ - 999	<html>3  (<font color=red>0</font>)</html>
HC - HZ - business	<html>25  (<font color=red>0</font>)</html>
HC - HZ - christmas	<html>129  (<font color=red>4</font>)</html>
HC - VT - 999	<html>1  (<font color=red>0</font>)</html>
HC - VT - business	<html>4  (<font color=red>0</font>)</html>
HC - VT - christmas	<html>66  (<font color=red>1</font>)</html>
HM - HZ - life moments - QUINCE	<html>3  (<font color=red>0</font>)</html>
HM - HZ - wedding	<html>3  (<font color=red>0</font>)</html>
HM - HZ - wedding - magnet	<html>70  (<font color=red>1</font>)</html>
HM - VT - life moments - QUINCE	<html>8  (<font color=red>0</font>)</html>
HM - VT - wedding	<html>5  (<font color=red>0</font>)</html>
HM - VT - wedding - magnet	<html>92  (<font color=red>2</font>)</html>
HMA - HZ - wedding - left	<html>0  (<font color=red>10</font>)</html>
HMA - HZ - wedding - right	<html>0  (<font color=red>6</font>)</html>
HMA - VT - wedding	<html>0  (<font color=red>195</font>)</html>
HMB - wedding	<html>0  (<font color=red>191</font>)</html>
HMC - HZ - wedding - left	<html>0  (<font color=red>10</font>)</html>
HMC - HZ - wedding - right	<html>0  (<font color=red>5</font>)</html>
HMC - VT - wedding	<html>0  (<font color=red>175</font>)</html>
HN - HZ - business	<html>2  (<font color=red>0</font>)</html>
HN - HZ - business - magnet	<html>19  (<font color=red>0</font>)</html>
HN - HZ - life moments - QUINCE	<html>2  (<font color=red>0</font>)</html>
HN - HZ - wedding	<html>1  (<font color=red>0</font>)</html>
HN - HZ - wedding - magnet	<html>84  (<font color=red>3</font>)</html>
HN - VT - business	<html>0  (<font color=red>0</font>)</html>
HN - VT - business - magnet	<html>24  (<font color=red>0</font>)</html>
HN - VT - life moments - QUINCE	<html>9  (<font color=red>0</font>)</html>
HN - VT - wedding	<html>2  (<font color=red>0</font>)</html>
HN - VT - wedding - magnet	<html>138  (<font color=red>4</font>)</html>
HO - HZ - wedding	<html>5  (<font color=red>0</font>)</html>
HO - HZ - wedding - magnet	<html>45  (<font color=red>1</font>)</html>
HO - VT - wedding	<html>5  (<font color=red>0</font>)</html>
HO - VT - wedding - backvt - magnet	<html>84  (<font color=red>4</font>)</html>
HO - VT - wedding - magnet	<html>1  (<font color=red>1</font>)</html>
HPA - wedding	<html>207  (<font color=red>3</font>)</html>
HRT - 999 - wedding	<html>2  (<font color=red>5</font>)</html>
HRT - 999 business	<html>2  (<font color=red>0</font>)</html>
HRT - wedding - WW	<html>31  (<font color=red>0</font>)</html>
HS - HZ - wedding	<html>109  (<font color=red>4</font>)</html>
HS - VT - wedding	<html>38  (<font color=red>0</font>)</html>
INVC - HZ - 999 weddings	<html>2  (<font color=red>0</font>)</html>
INVC - HZ - Weddings - WW	<html>27  (<font color=red>0</font>)</html>
INVC - life moments - QUINCE	<html>11  (<font color=red>0</font>)</html>
INVC - VT - 999 weddings	<html>6  (<font color=red>0</font>)</html>
INVC - VT - Weddings -WW	<html>480  (<font color=red>1</font>)</html>
INVCA - HZ - 999 weddings	<html>0  (<font color=red>0</font>)</html>
INVCA - HZ - Weddings - WW	<html>3  (<font color=red>0</font>)</html>
INVCA - VT - 999 weddings	<html>2  (<font color=red>0</font>)</html>
INVCA - VT - Weddings - WW	<html>167  (<font color=red>1</font>)</html>
INVCB - HZ - 999 weddings	<html>0  (<font color=red>0</font>)</html>
INVCB - HZ - Weddings - WW	<html>2  (<font color=red>0</font>)</html>
INVCB - VT - 999 weddings	<html>2  (<font color=red>0</font>)</html>
INVCB - VT - Weddings - WW	<html>168  (<font color=red>0</font>)</html>
INVCC - HZ - 999 weddings	<html>1  (<font color=red>0</font>)</html>
INVCC - HZ - Weddings - WW	<html>3  (<font color=red>0</font>)</html>
INVCC - VT - 999 weddings	<html>2  (<font color=red>0</font>)</html>
INVCC - VT - Weddings -WW	<html>170  (<font color=red>0</font>)</html>
INVCD - HZ - 999 weddings	<html>0  (<font color=red>0</font>)</html>
INVCD - HZ - Weddings - WW	<html>2  (<font color=red>0</font>)</html>
INVCD - VT - 999 weddings	<html>2  (<font color=red>0</font>)</html>
INVCD - VT - Weddings - WW	<html>170  (<font color=red>0</font>)</html>
INVCE - HZ - 999 weddings	<html>0  (<font color=red>0</font>)</html>
INVCE - HZ - Weddings - WW	<html>2  (<font color=red>0</font>)</html>
INVCE - VT - 999 weddings	<html>2  (<font color=red>0</font>)</html>
INVCE - VT - Weddings - WW	<html>169  (<font color=red>0</font>)</html>
INVCF - HZ - 999 weddings	<html>0  (<font color=red>0</font>)</html>
INVCF - HZ - Weddings - WW	<html>2  (<font color=red>0</font>)</html>
INVCF - VT - 999 weddings	<html>2  (<font color=red>0</font>)</html>
INVCF - VT - Weddings - WW	<html>170  (<font color=red>0</font>)</html>
INVF - 999 wedding	<html>2  (<font color=red>0</font>)</html>
INVF - wedding	<html>525  (<font color=red>99</font>)</html>
INVG - 999 wedding	<html>2  (<font color=red>0</font>)</html>
INVG - wedding	<html>513  (<font color=red>99</font>)</html>
INVP - Weddings - WW	<html>337  (<font color=red>47</font>)</html>
INVR - Weddings - WW	<html>226  (<font color=red>1</font>)</html>
INVU - Weddings - WW	<html>191  (<font color=red>17</font>)</html>
INVV - 999 weddings	<html>6  (<font color=red>0</font>)</html>
INVV - Weddings - WW	<html>271  (<font color=red>1</font>)</html>
INVW - HZ - 999 weddings	<html>2  (<font color=red>0</font>)</html>
INVW - HZ - Weddings - WW	<html>15  (<font color=red>0</font>)</html>
INVW - VT - 999 weddings	<html>6  (<font color=red>0</font>)</html>
INVW - VT - Weddings - WW	<html>176  (<font color=red>1</font>)</html>
J - business	<html>0  (<font color=red>0</font>)</html>
JB - 999 business	<html>4  (<font color=red>0</font>)</html>
JB - school	<html>10  (<font color=red>2</font>)</html>
JK - 999 business	<html>4  (<font color=red>0</font>)</html>
JK - school	<html>21  (<font color=red>0</font>)</html>
JR - 999 business	<html>2  (<font color=red>0</font>)</html>
JR - business	<html>59  (<font color=red>39</font>)</html>
JR - business - WW	<html>0  (<font color=red>0</font>)</html>
K - 999 business	<html>4  (<font color=red>0</font>)</html>
K - school	<html>19  (<font color=red>1</font>)</html>
KB - 999 business	<html>6  (<font color=red>0</font>)</html>
KB - school	<html>40  (<font color=red>1</font>)</html>
KC - 999 business	<html>4  (<font color=red>0</font>)</html>
KC - school	<html>0  (<font color=red>0</font>)</html>
LA - wedding	<html>372  (<font color=red>10</font>)</html>
LA - wedding 999	<html>2  (<font color=red>0</font>)</html>
LB - wedding	<html>410  (<font color=red>13</font>)</html>
LB - wedding 999	<html>2  (<font color=red>0</font>)</html>
LC - wedding	<html>264  (<font color=red>10</font>)</html>
LC - wedding 999	<html>2  (<font color=red>0</font>)</html>
LD - wedding	<html>372  (<font color=red>11</font>)</html>
LD - wedding 999	<html>2  (<font color=red>0</font>)</html>
LE - wedding	<html>349  (<font color=red>10</font>)</html>
LE - wedding 999	<html>2  (<font color=red>0</font>)</html>
LF - wedding	<html>320  (<font color=red>11</font>)</html>
LF - wedding 999	<html>2  (<font color=red>0</font>)</html>
LG - wedding	<html>321  (<font color=red>11</font>)</html>
LG - wedding 999	<html>2  (<font color=red>0</font>)</html>
LJ - wedding	<html>205  (<font color=red>5</font>)</html>
LJ - wedding 999	<html>4  (<font color=red>0</font>)</html>
LO - wedding	<html>448  (<font color=red>10</font>)</html>
LO - wedding 999	<html>12  (<font color=red>0</font>)</html>
LW - business - WW	<html>0  (<font color=red>0</font>)</html>
LW - wedding - business - life moments	<html>1737  (<font color=red>176</font>)</html>
LW - wedding - business - life moments 999	<html>6  (<font color=red>0</font>)</html>
LW - wedding - business - life moments Test	<html>0  (<font color=red>0</font>)</html>
LW - wedding - life moments WW	<html>0  (<font color=red>0</font>)</html>
LWL - business	<html>298  (<font color=red>18</font>)</html>
LWL - business 999	<html>0  (<font color=red>0</font>)</html>
M - HZ - 999 business	<html>4  (<font color=red>0</font>)</html>
M - HZ - business	<html>26  (<font color=red>3</font>)</html>
M - HZ - school	<html>44  (<font color=red>0</font>)</html>
M - VT - 999 business	<html>4  (<font color=red>0</font>)</html>
M - VT - business	<html>65  (<font color=red>9</font>)</html>
M - VT - school	<html>52  (<font color=red>27</font>)</html>
MA - 999 business	<html>313  (<font color=red>0</font>)</html>
MCC - wedding	<html>118  (<font color=red>2</font>)</html>
MCV - wedding	<html>117  (<font color=red>2</font>)</html>
MCW - wedding	<html>219  (<font color=red>3</font>)</html>
MLRA - 999 business	<html>0  (<font color=red>0</font>)</html>
MLRA - business	<html>0  (<font color=red>0</font>)</html>
MLRA - business (Plain) WW	<html>367  (<font color=red>10</font>)</html>
MM - business	<html>9  (<font color=red>2</font>)</html>
MM - business (w)	<html>0  (<font color=red>0</font>)</html>
MMIK - business	<html>6  (<font color=red>13</font>)</html>
MMIK - business (w)	<html>0  (<font color=red>0</font>)</html>
MMIK - wedding	<html>207  (<font color=red>2</font>)</html>
MMIK - wedding (w)	<html>0  (<font color=red>0</font>)</html>
NA - 999 business	<html>2  (<font color=red>0</font>)</html>
NA - business	<html>70  (<font color=red>2</font>)</html>
NAU - 999 business	<html>2  (<font color=red>0</font>)</html>
NAU - business	<html>70  (<font color=red>2</font>)</html>
P - 999 business	<html>6  (<font color=red>0</font>)</html>
PFC - wedding	<html>169  (<font color=red>5</font>)</html>
PFH - wedding	<html>31  (<font color=red>0</font>)</html>
PFS - wedding	<html>27  (<font color=red>0</font>)</html>
PFV - wedding	<html>109  (<font color=red>3</font>)</html>
PGT - wedding	<html>73  (<font color=red>2</font>)</html>
pixeldust marketing	<html>0  (<font color=red>0</font>)</html>
PRC - wedding	<html>181  (<font color=red>5</font>)</html>
PRK - wedding	<html>183  (<font color=red>5</font>)</html>
PRT - wedding	<html>126  (<font color=red>3</font>)</html>
PRU - wedding	<html>100  (<font color=red>3</font>)</html>
PRV - wedding	<html>108  (<font color=red>4</font>)</html>
PRW - wedding	<html>235  (<font color=red>5</font>)</html>
PSMS	<html>8  (<font color=red>0</font>)</html>
PTK - wedding	<html>73  (<font color=red>2</font>)</html>
PTV - wedding	<html>72  (<font color=red>2</font>)</html>
Q - 999 business	<html>3  (<font color=red>0</font>)</html>
QB - 999 business	<html>3  (<font color=red>0</font>)</html>
QC - 999 business	<html>3  (<font color=red>0</font>)</html>
QCS - 999 business	<html>1  (<font color=red>0</font>)</html>
R - HZ - 999 business	<html>4  (<font color=red>0</font>)</html>
R - HZ - business	<html>24  (<font color=red>8</font>)</html>
R - HZ - school	<html>10  (<font color=red>22</font>)</html>
R - VT - 999 business	<html>4  (<font color=red>0</font>)</html>
R - VT - business	<html>4  (<font color=red>1</font>)</html>
R - VT - school	<html>5  (<font color=red>0</font>)</html>
RECB - wedding	<html>406  (<font color=red>12</font>)</html>
RECC - wedding	<html>300  (<font color=red>11</font>)</html>
RECD - wedding	<html>305  (<font color=red>11</font>)</html>
RECE - wedding	<html>395  (<font color=red>12</font>)</html>
RFP 200 - business	<html>1  (<font color=red>0</font>)</html>
RFP 204 - business	<html>1  (<font color=red>0</font>)</html>
RFP 205 - business	<html>1  (<font color=red>0</font>)</html>
RFP 207 - business	<html>0  (<font color=red>1</font>)</html>
RFP 211 - business	<html>1  (<font color=red>0</font>)</html>
RFP 212 - business	<html>1  (<font color=red>0</font>)</html>
RFP 224 - business	<html>1  (<font color=red>0</font>)</html>
RFP 225 - business	<html>1  (<font color=red>0</font>)</html>
RFP 227 - business	<html>1  (<font color=red>0</font>)</html>
RFP 235 - business	<html>1  (<font color=red>0</font>)</html>
RFP 236 - business	<html>2  (<font color=red>0</font>)</html>
RFP 237 - business	<html>1  (<font color=red>0</font>)</html>
RFP 238 - business	<html>1  (<font color=red>0</font>)</html>
RFP 239 - business	<html>1  (<font color=red>0</font>)</html>
RFP 240 - business	<html>3  (<font color=red>0</font>)</html>
RIBC - 999 business	<html>2  (<font color=red>0</font>)</html>
RIBD - 999 business	<html>2  (<font color=red>0</font>)</html>
RMT 100 - business	<html>4  (<font color=red>94</font>)</html>
RMT 101 - business	<html>4  (<font color=red>0</font>)</html>
RMT 102 - business	<html>4  (<font color=red>4</font>)</html>
RMT 104 - business	<html>4  (<font color=red>0</font>)</html>
RMT 113 - business	<html>4  (<font color=red>0</font>)</html>
RMT 114 - business	<html>4  (<font color=red>0</font>)</html>
RMTH 100 - business	<html>3  (<font color=red>0</font>)</html>
RMTH 101 - business	<html>3  (<font color=red>0</font>)</html>
RMTH 102 - business	<html>3  (<font color=red>0</font>)</html>
RMTH 104 - business	<html>3  (<font color=red>0</font>)</html>
RMTH 113 - business	<html>3  (<font color=red>0</font>)</html>
RMTH 114 - business	<html>5  (<font color=red>0</font>)</html>
RPA - wedding	<html>225  (<font color=red>3</font>)</html>
RPB - wedding	<html>224  (<font color=red>3</font>)</html>
RPC - wedding	<html>224  (<font color=red>4</font>)</html>
RW - HZ - 999 - life moments	<html>0  (<font color=red>0</font>)</html>
RW - HZ - 999 - wedding	<html>4  (<font color=red>0</font>)</html>
RW - HZ - life moments - BABY	<html>56  (<font color=red>14</font>)</html>
RW - HZ - life moments - GRAD	<html>6  (<font color=red>3</font>)</html>
RW - HZ - life moments - PARTY	<html>28  (<font color=red>0</font>)</html>
RW - HZ - wedding - WW	<html>23  (<font color=red>9</font>)</html>
RW - HZ - wedding - WW Carrier	<html>40  (<font color=red>0</font>)</html>
RW - VT - 999 - life moments	<html>0  (<font color=red>0</font>)</html>
RW - VT - 999 - wedding	<html>4  (<font color=red>0</font>)</html>
RW - VT - life moments - BABY	<html>80  (<font color=red>12</font>)</html>
RW - VT - life moments - GRAD	<html>11  (<font color=red>7</font>)</html>
RW - VT - life moments - PARTY	<html>65  (<font color=red>0</font>)</html>
RW - VT - wedding - WW	<html>57  (<font color=red>0</font>)</html>
RW - VT - wedding - WW Carrier	<html>76  (<font color=red>0</font>)</html>
RWL - HZ - 999 - life moments	<html>2  (<font color=red>0</font>)</html>
RWL - HZ - 999 - wedding	<html>2  (<font color=red>0</font>)</html>
RWL - HZ - life moments - BABY	<html>56  (<font color=red>14</font>)</html>
RWL - HZ - life moments - GRAD	<html>6  (<font color=red>3</font>)</html>
RWL - HZ - life moments - PARTY	<html>28  (<font color=red>0</font>)</html>
RWL - HZ - wedding - WW	<html>63  (<font color=red>2</font>)</html>
RWL - VT - 999 -  life moments	<html>2  (<font color=red>0</font>)</html>
RWL - VT - 999 -  wedding	<html>2  (<font color=red>0</font>)</html>
RWL - VT - life moments - BABY	<html>80  (<font color=red>12</font>)</html>
RWL - VT - life moments - GRAD	<html>11  (<font color=red>7</font>)</html>
RWL - VT - life moments - PARTY	<html>65  (<font color=red>0</font>)</html>
RWL - VT - wedding - WW	<html>132  (<font color=red>0</font>)</html>
S - business	<html>5  (<font color=red>0</font>)</html>
SA - 999 business	<html>2  (<font color=red>0</font>)</html>
SB - 999 business	<html>2  (<font color=red>0</font>)</html>
SC - 999 business	<html>2  (<font color=red>0</font>)</html>
SD - 999 business	<html>2  (<font color=red>0</font>)</html>
SERIES - XT	<html>7  (<font color=red>0</font>)</html>
SERIES - XTS	<html>1  (<font color=red>0</font>)</html>
SERIES - XU	<html>7  (<font color=red>0</font>)</html>
SERIES - XUS	<html>1  (<font color=red>0</font>)</html>
SERIES - XV	<html>7  (<font color=red>0</font>)</html>
SIK - business (No Composite) WW	<html>14  (<font color=red>0</font>)</html>
SIK - business (Plain Backside) WW	<html>77  (<font color=red>118</font>)</html>
SIK - business Baseball 100 (Composite) WW	<html>32  (<font color=red>0</font>)</html>
SIK - business Baseball 150 (Composite) WW	<html>32  (<font color=red>0</font>)</html>
SIK - business Football 200 (Composite) WW	<html>272  (<font color=red>117</font>)</html>
SIK - business Football 250 (Composite) WW	<html>0  (<font color=red>0</font>)</html>
SIK - business Hockey/Basketball (Backside) WW	<html>62  (<font color=red>0</font>)</html>
SPA - weddings	<html>0  (<font color=red>76</font>)</html>
SPB - weddings	<html>0  (<font color=red>76</font>)</html>
SPC - weddings	<html>0  (<font color=red>76</font>)</html>
T - business	<html>1  (<font color=red>4</font>)</html>
T 100 - business	<html>1  (<font color=red>0</font>)</html>
T 101 - business	<html>1  (<font color=red>0</font>)</html>
T 102 - business	<html>1  (<font color=red>0</font>)</html>
T 104 - business	<html>1  (<font color=red>0</font>)</html>
T 113 - business	<html>1  (<font color=red>0</font>)</html>
T 114 - business	<html>1  (<font color=red>0</font>)</html>
Test 1	<html>0  (<font color=red>0</font>)</html>
U - 999 business	<html>7  (<font color=red>0</font>)</html>
UJC - 999 business	<html>2  (<font color=red>0</font>)</html>
UJO - 999 business	<html>2  (<font color=red>0</font>)</html>
V - 999 business	<html>2  (<font color=red>0</font>)</html>
VB - 999 business	<html>2  (<font color=red>0</font>)</html>
VC - HZ - weddings	<html>16  (<font color=red>0</font>)</html>
VC - VT - weddings	<html>206  (<font color=red>4</font>)</html>
VK - weddings	<html>224  (<font color=red>3</font>)</html>
VN - HZ - weddings	<html>0  (<font color=red>15</font>)</html>
VN - VT - weddings	<html>0  (<font color=red>281</font>)</html>
VP - weddings	<html>257  (<font color=red>10</font>)</html>
VT - weddings	<html>0  (<font color=red>188</font>)</html>
VU - weddings	<html>189  (<font color=red>3</font>)</html>
VV - weddings	<html>212  (<font color=red>3</font>)</html>
VW - HZ - weddings	<html>15  (<font color=red>0</font>)</html>
VW - VT - weddings	<html>173  (<font color=red>4</font>)</html>
W - 999 business	<html>2  (<font color=red>0</font>)</html>
weddings_banner	<html>0  (<font color=red>0</font>)</html>
weddings_browse_banner_full	<html>0  (<font color=red>0</font>)</html>
weddings_landing_pages	<html>0  (<font color=red>0</font>)</html>
weddings_landing_pages_full	<html>0  (<font color=red>0</font>)</html>
weddings_social	<html>0  (<font color=red>0</font>)</html>
WFA - weddings	<html>117  (<font color=red>4</font>)</html>
WFB - weddings	<html>118  (<font color=red>4</font>)</html>
WFC - weddings	<html>118  (<font color=red>4</font>)</html>
WFD - weddings	<html>179  (<font color=red>5</font>)</html>
X - business	<html>0  (<font color=red>42</font>)</html>
XAL - HZ - 999 weddings	<html>4  (<font color=red>0</font>)</html>
XAL - HZ - business (w)	<html>0  (<font color=red>0</font>)</html>
XAL - HZ - weddings	<html>55  (<font color=red>0</font>)</html>
XAL - HZ - weddings (w)	<html>0  (<font color=red>0</font>)</html>
XAL - VT - 999 weddings	<html>4  (<font color=red>0</font>)</html>
XAL - VT - business (w)	<html>0  (<font color=red>0</font>)</html>
XAL - VT - weddings	<html>65  (<font color=red>3</font>)</html>
XAL - VT - weddings (w)	<html>0  (<font color=red>0</font>)</html>
XB - HZ - business	<html>2  (<font color=red>0</font>)</html>
XB - VT - business 	<html>0  (<font color=red>0</font>)</html>
XE - HZ - 999 - life moments	<html>0  (<font color=red>0</font>)</html>
XE - HZ - 999 - weddings	<html>2  (<font color=red>0</font>)</html>
XE - HZ - weddings - WW	<html>216  (<font color=red>37</font>)</html>
XE - VT - 999 - life moments	<html>0  (<font color=red>0</font>)</html>
XE - VT - 999 - weddings	<html>2  (<font color=red>0</font>)</html>
XE - VT - weddings WW	<html>200  (<font color=red>21</font>)</html>
XG - HZ - 999 - life moments	<html>0  (<font color=red>0</font>)</html>
XG - HZ - 999 - weddings	<html>2  (<font color=red>0</font>)</html>
XG - HZ - weddings - WW	<html>87  (<font color=red>0</font>)</html>
XG - VT - 999 - life moments	<html>0  (<font color=red>0</font>)</html>
XG - VT - 999 - weddings	<html>2  (<font color=red>0</font>)</html>
XG - VT - weddings - WW	<html>140  (<font color=red>1</font>)</html>
XN - HZ - business	<html>2  (<font color=red>0</font>)</html>
XN - VT - business	<html>6  (<font color=red>0</font>)</html>
XN - VT - business - generic	<html>1  (<font color=red>0</font>)</html>
XN - VT - christmas - t calendar	<html>0  (<font color=red>0</font>)</html>
XO - HZ - business	<html>2  (<font color=red>0</font>)</html>
XO - VT - business	<html>2  (<font color=red>0</font>)</html>
XP - weddings	<html>70  (<font color=red>2</font>)</html>
XRD - HZ - business	<html>6  (<font color=red>0</font>)</html>
XRD - VT - business	<html>27  (<font color=red>0</font>)</html>
XT - business HZ	<html>308  (<font color=red>15</font>)</html>
XT - business HZ (w)	<html>0  (<font color=red>0</font>)</html>
XT - business HZ 999	<html>3  (<font color=red>1</font>)</html>
XT - business VT	<html>0  (<font color=red>0</font>)</html>
XT - business VT (w)	<html>0  (<font color=red>0</font>)</html>
XTS - business HZ	<html>101  (<font color=red>7</font>)</html>
XTS - business HZ (w)	<html>0  (<font color=red>0</font>)</html>
XTS - business HZ 999	<html>2  (<font color=red>0</font>)</html>
XU - business HZ	<html>278  (<font color=red>10</font>)</html>
XU - business HZ (w)	<html>0  (<font color=red>0</font>)</html>
XU - business HZ 999	<html>3  (<font color=red>0</font>)</html>
XUS - business HZ	<html>79  (<font color=red>6</font>)</html>
XUS - business HZ (w)	<html>0  (<font color=red>0</font>)</html>
XUS - business HZ 999	<html>2  (<font color=red>0</font>)</html>
XV - business HZ	<html>269  (<font color=red>12</font>)</html>
XV - business HZ (w)	<html>0  (<font color=red>0</font>)</html>
XV - business HZ 999	<html>2  (<font color=red>0</font>)</html>
XVS - business HZ	<html>1  (<font color=red>42</font>)</html>
XVS - business HZ (w)	<html>0  (<font color=red>0</font>)</html>
Y - HZ - 999 - life moments	<html>2  (<font color=red>0</font>)</html>
Y - HZ - 999 - weddings	<html>2  (<font color=red>0</font>)</html>
Y - HZ - schools	<html>0  (<font color=red>2</font>)</html>
Y - HZ - weddings - WW	<html>238  (<font color=red>41</font>)</html>
Y - VT - 999 - life moments	<html>2  (<font color=red>0</font>)</html>
Y - VT - 999 - weddings	<html>2  (<font color=red>25</font>)</html>
Y - VT - weddings - WW	<html>262  (<font color=red>1</font>)</html>
YB - HZ - 999 - business	<html>2  (<font color=red>0</font>)</html>
YB - HZ - 999 - life moments	<html>2  (<font color=red>0</font>)</html>
YB - HZ - 999 - weddings	<html>2  (<font color=red>0</font>)</html>
YB - HZ - business inserts	<html>240  (<font color=red>8</font>)</html>
YB - HZ - life moments - BABY	<html>87  (<font color=red>0</font>)</html>
YB - HZ - life moments - GRAD	<html>7  (<font color=red>3</font>)</html>
YB - HZ - life moments - PARTY	<html>23  (<font color=red>0</font>)</html>
YB - HZ - weddings - WW	<html>115  (<font color=red>3</font>)</html>
YB - VT - 999 - business	<html>2  (<font color=red>0</font>)</html>
YB - VT - 999 - life moments	<html>0  (<font color=red>0</font>)</html>
YB - VT - 999 - weddings	<html>4  (<font color=red>0</font>)</html>
YB - VT - life moments - BABY	<html>88  (<font color=red>0</font>)</html>
YB - VT - life moments - GRAD	<html>9  (<font color=red>7</font>)</html>
YB - VT - life moments - PARTY	<html>63  (<font color=red>0</font>)</html>
YB - VT - weddings - WW	<html>196  (<font color=red>0</font>)</html>
YBC - HZ - 999 business inserts	<html>3  (<font color=red>0</font>)</html>
YBC - HZ - business inserts	<html>3  (<font color=red>0</font>)</html>
YBC - VT - 999 business inserts	<html>1  (<font color=red>0</font>)</html>
YBC - VT - business inserts	<html>8  (<font color=red>1</font>)</html>
YBFP - HZ - 999 business inserts	<html>2  (<font color=red>0</font>)</html>
YBFP - HZ - business inserts	<html>14  (<font color=red>0</font>)</html>
YBFP - VT - 999 business inserts	<html>0  (<font color=red>0</font>)</html>
Z - HZ - 999 business	<html>2  (<font color=red>0</font>)</html>
Z - HZ - business	<html>246  (<font color=red>15</font>)</html>
Z - VT - 999 business	<html>2  (<font color=red>0</font>)</html>
Z - VT - business	<html>35  (<font color=red>7</font>)</html>
